岗位薪资,数量
15000.0-30000.0,2
360000.0-600000.0,2
15001.0-20000.0,1
10000.0-20000.0,1
15000.0-20000.0,1
120000.0-240000.0,1
180000.0-240000.0,1
