岗位薪资,数量
12000.0-20000.0,1
10000.0-15000.0,1
9000.0-14000.0,1
15000.0-20000.0,1
6001.0-8000.0,1
18001.0-35000.0,1
12000.0-18000.0,1
